111111111111111111111
100000000000000000001
1000c000000000c000001
100000000000000000001
1000C0000000E00000001
100000000P00000C000001
100000000000000000001
10000C000000000000001
10000000C000C00000001
100000000000000000001
111111111111111111111