11111
102E1
10001
1P0C1
11111
