1111111111
10010000E1
1001100001
1000011101
1111000011
1000000001
1000010001
1000010001
1P000100C1
1111111111